1111111111111101111111111111111
1222222221111101111122221122221
1211121121111101111121121121121
1211121121111101111121122221121
1211121121111101111121111121121
1211121121111101111121111121121
1222222222222222222222222221121
1211121111111101111121121111121
1211121111111101111121121111121
1211122221100000000021122221121
1211121121101111101121121121121
1211121121101000101121121121121
1222221120001000101122221122221
1111121111101000101111101111121
1111121111101000101111101111121
1222221120001000101122221122221
1211121121101000101121121121121
1211121121101111101121121121121
1211122221100000000021122221121
1211121111111101111121121111121
1211121111111101111121121111121
1222222222222222222222222221121
1211121121111101111121111121121
1211121121111101111121111121121
1211121121111101111121122221121
1211121121111101111121121121121
1222222221111101111122221122221
1111111111111101111111111111111